NO ./textures/NO.xpm
SO ./textures/SO.xpm
EA ./textures/EA.xpm
WE ./textures/WE.xpm

F 3,132,131
C 212,222,255





1111111111111111111111111
100000000000001000000001
1000000000000000000000001
100000000000000000100001
1000000000000000000000001
1000000N0000000000000011
100100000000000000000001
1001000000000000000000001
1001000000000000000000001
100100000000000000000001
100100000000000000000001
1001000000000000000000001
1001000000000000000000001
1111111111111111111111111
