        1111111111111111111111111
p       1110000000110000000000001
        10110k0001110000000000001
        1001000000000000000000001



111111111011000001110000000000001111111111
100000000011000001110111111111111
11110111111111011111111110001
111101111111110111      1010010001
110000001101010010111111110001
10000  000000000001100000010001
10000000000000001101010010001
11000001111101011111011110N0111
1111011111 101011 11111010001
1111111111 111111 11111111111