



1111111111111111111111111 jjjjj
1000000000110000000000001
1011000001110000000000001
1001000000000000000000001
11111111101100000111000001


100000000011000001110111111111111
111101 11111111011100000010001
11110111111111011101010010001
11000000110101011100000010001
10000000000000001100000010001
10000000000000001101010010001
11000001110101011111011110N0111
11110111 1110101 101111010001
11111111 1111111 111111111110



NO ./path_to_the_north_texture
SO ./path_to_the_south_texture
WE ./path_to_the_west_texture
EA vvvv
F 0,100,11
C 225,255,1


