NO ./path_to_the_north_texture
SO ./path_to_the_south_texture
WE ./path_to_the_west_texture
EA vvvv
F 0,100,11
C 225,255,1



1111111111111111111111111
1000000000110000000000001
1011000001110000110000001
1001000000000000000000001
1111111110110000011100001
100100000N000000000000011111
1001000000000000000000001
1001000000000000000000001
1111111111111111111111111