NO  ./textures/NO.xpm
SO ./textures/SO.xpm
EA ./textures/EA.xpm
WE ./textures/WE.xpm






F 3,132,131
C 212,222,255


1111111111111111111111111
100000000000001000001
1000000000000000000001111
1000011000000000010000111
1000000100000000000000001
1000000000000000000000111
1001000000000000000000011
1001000000000000000000011
1001000000000000000000001
1001000000000000000000011
10010000000000N0000000011
1001000000000000000000001
1001000000000000000000001
1111111111111111111111111
