11111011111111111111111
100000 0111001
1111N00000111011
111111111111111