1N1110111111111
100000 0111001
1111 00000111011
111111111111111