1111111111111111111111111
111N000000110000000000001
101100001110000000000001
100100000000000000000001
111111111011000001110000000000001111111111
100000000011000001110111111111111
111101111111110111111111100000001
111101111111110111     1010010001
1100000011010100101111111100000111
1000000000000000001100000010011
10000000000000001101010010001
11000111110101111101111000111
1111011111 101011 11111010001
1111111111 111111 11111111111