NO ./path_to_the_north_texture
SO ./path_to_the_south_texture
WE ./path_to_the_west_texture
EA vvvv
F 0,100,11
C 225,255,1



1111111111111111111111111
1000000000000001000000001
1000000000000000000000001
1000000010000000000100001
1000000100000N00000000001
1000000000000000000000011
1001000000000000000000001
1001000000000000000000001
1001000000000000000000001
1001000000000000000000001
1001000000000000000000001
1111111111111111111111111
