SO ./textures/SO.xpm
EA ./textures/EA.xpm
NO ./textures/NO.xpm

F 3,132,131
C 212,222,25
WE ./textures/WE.xpm
        1111111111
111111110000011001111111111
100000000000000000000001
100001000010000000100001
1000000001 10000000000001
100000000010000000000011
100100000000000000000001
10010000N0000000000000001
1001000000000000000000001
100100000000000000000001
100100000000000000000001
1001000000000000000000001
1001000000000000000000001
1111111111111111111111111