SO ./bonus/textures/SO.xpm
EA ./bonus/textures/EA.xpm
NO ./bonus/textures/NO.xpm    
WE ./bonus/textures/WE.xpm
F 64,0,0
C 212,222,25


        1111111111
111111110000011001111111111
100000000000000000000001
100001000000000000100001
100000000000000000000001
100000000000000000000011
100100000000000000000001
10010000000000000000001
100100000000000000000011
100100000N000000000000001
100100000000000000000001
1001000000000000000000001
1001000000000000000000001
1111111111111111111111111