SO ./mandatory/textures/SO.xpm
EA ./mandatory/textures/EA.xpm
NO ./mandatory/textures/NO.xpm    
WE ./mandatory/textures/WE.xpm
F 51,25,0
C 0,204,204


        1111111111
111111111111111111111111
100100000000000000000001
100100000000000000000001
100100000000000000000001
1000000000000000N0000011
100100000000000000000001
10010000000000000000001
11111111111111111111111